########
#S#    #
# # ## #
# # E# #
#    # #
########