####################
# #  # #     #     #
# # ## # ### # # ###
#      # # #   #   #
## ## ## # # # ### #
#  #  #  # # #   # #
# ### #### # # # # #
# # #    # # # # # #
# # #### # # # # # #
# # #    # # #   # #
#   # ## # # ##### #
#####  # # # #     #
#      #   # #######
# ###### ### #     #
# #   S# #   # # ###
# # #### ### # # # #
# #    #   # # # E #
# #### ##### ### ###
#                  #
####################