#####
#S# #
# # #
#   #
#E# #
### #
#   #
# # #
#   #
#####