###############
#   #    #    #
# # # ## # ## #
# #   ## #    #
# ### ####### #
#S  #     #   #
### # ### # ###
#   #   # #   #
# # ### # ### #
# #     #     #
# # ######### #
# # #         #
# # # ####  ###
#   #      E  #
############### 