########
#S     #
#### # #
#    # #
# #### #
# #E   #
# #    #
########
