############
#S   #     #
## # # #####
#  # # #   #
## ### # # #
# E      # #
## ### ### #
############