##########
#S#      #
# # ## ###
# # #    #
# # # ####
#   #    #
##### ####
#   #    #
## ## ## #
#      # #
## ##### #
#   #    #
# # ######
# #   #  #
# ### ## #
#   # #  #
### # # ##
#   #   E#
# #####  #
##########