#####
# #S#
#E# #
#   #
##### 